#########################
#S#           #       # #
# ### ####### # # ### # #
#     #     # # # #   # #
######### ### ### # ### #
# #       #   #   # #   #
# # ### # # ### ### # # #
#   # # # # #   # # # # #
# ### # ### ### # # ### #
#     #     #   # # #   #
##### ####### ### # # # #
#   #       # # #   # # #
# ######### # # # ### # #
#         # # #   #   # #
# ##### # # # # ### ### #
#     # # #   #     #   #
##### # # ########### ###
# #   # # #         #   #
# # ### ### ### ####### #
# #   #     # # #   #   #
# ### ####### # # # # ###
#   #         #   # # # #
# ########### ##### # # #
#                 #    E#
#########################
