######
#S   #
# ####
# ## #
#  #E#
######
