###################################################
#S#     #                             #           #
# # ### # ############### ########### # ### #######
#   # # # # #         #   #         # #   #       #
##### # # # # ####### # ### ######### ##### ##### #
# #   # # # # #     # # #       #     #   #     # #
# # # # # # # # ### # # # ##### # ##### # ####### #
#   # # #   # #   # #   # #   #   #     #       # #
# ### # ##### ### # ##### # # ##### ########### # #
# # # #     #     # #     # # #     #         # # #
# # # ##### ##### # # ##### # # ### # ##### ### # #
# # #     # #   # # #       # # #   #   # #     # #
# # # ##### # # ### ######### ### ##### # ####### #
# # #     #   #   #   #   #   #   #   #           #
# # ##### ####### # # # # # ### ### ############# #
#   #   #       # # #   # # #   #       # #   #   #
### ### ####### # # ##### # # ### ### # # # # # ###
# #       #   #   #     # #   #   # # #   # # #   #
# ####### # # ######### # ##### ### # ##### # ### #
#       #   # # #       # #   # #   #       #     #
# ##### ##### # # ####### ### # # #################
#     #   #   #   #     #   # # #     #           #
# ##### # # ####### ### # # # # ### # # ######### #
# #     # # #       #   # # #       # #         # #
### ##### # ### ##### ##### ######### ####### ### #
#   #     #     #   # #   #     #   #   #   # #   #
# ####### ####### ### # # ##### # ### ### # # # ###
# #     #   #   #     # #       #     #   #   #   #
# # ### ##### # # ##### ####### ####### ######### #
# # # #       #   #   #       # #         #   #   #
# # # ############# # ##### # ### ####### # # # # #
# #   # #         # #     # #     #   #     # # # #
# ### # # ##### # # ##### ####### # # ######### # #
#   # #   #     #   #   # #     # # #     #     # #
### # ##### ######### # # # ### ### ##### # ##### #
#   # #   # #   #     # # #   #   # #   #   #     #
# ### # # # # # # # ### # # # ### # # # ####### ###
#     # #   # #   # #   # # # # # #   #       #   #
# ##### ##### ##### ### # ### # # # ######### ### #
# #     # #   #   #   # #     # # #         #   # #
# # # ### # ### # ### ######### # ############# # #
# # #   #     # #   #           #     #       # # #
# # ### ##### # ### ######### ####### # ##### # # #
# #   #   # #   #   #       #       # #     #   # #
# ####### # ##### ### # ### ### ### # ##### #######
#   #     # #     #   #   # # # #   # #   # #     #
### # ##### # ########### # # # ##### # # # # ### #
#   #     # #     #       # # # #   #   # #   #   #
# ####### # ##### # ####### # # # # ##### ##### # #
#         #         #         #   #             #E#
###################################################
