#######
#S    #
# ### #
# #   #
#   #E#
#######
