#######################################
#S#     #               #         #   #
# ### ### ####### ##### # ####### # # #
#   #     #   #   #   # # #   #   # # #
### # ##### # # ### # # # # # # ### # #
# # #     # #   # # #   #   # #     # #
# # ##### # ##### # ######### ####### #
# #     # # #     #   #       #   #   #
# ##### ### # ####### ####### # ### ###
# #   #     #       #       # #   #   #
# # # ####### ### # ####### # ### ### #
#   #     #   #   # #     # #   # #   #
##### ### # ### ### # ### # ### # # # #
#     #   # #   #   # #   #   #   # # #
# ##### ### # ### ### ### ### ##### # #
#   #   #   # # #   #   # # #       # #
# # # ### ### # ### ### # # ######### #
# # # # # # # #         # # #       # #
### # # # # # ########### # # ### ### #
#   #   #   #         #     #   #   # #
# ### ##### ######### ######### ### # #
# #   #     #   #   #         # # # # #
# ### # ##### # # # ######### # # # # #
#   # # #     #   #   # #     #   #   #
# # ### ### ######### # # ####### #####
# #         #           #            E#
#######################################
