###############
#S  #     #   #
### # ##### # #
# # #       # #
# # ######### #
# #   #       #
# ### # ##### #
#     #   #   #
# ####### ### #
#       #   # #
####### ### ###
#     #   #   #
# ####### ### #
#            E#
###############
